####################
#....$.............#
#..................#
#........####....###
#.#######..........#
#..................#
#................###
#.......#######....#
#..................#
#.................##
#...########.......#
#..................#
#........######....#
#...#.............##
#..................#
########...........#
#...........###....#
#..................#
#..................#
####################
