##########################################
#....................$...................#
#.#......................................#
#.#......................................#
#.#######.......####....####....####....##
#.#......................................#
#.#......................................#
#.#.....#######.........................##
#.#......................................#
#.#......................................#
#.#..##.................................##
#.#......................#########.......#
#.#......######..........................#
#.#.....................................##
#.#......................................#
#.######.................................#
#..........#######........######........##
#........................................#
#........................................#
##########################################
